1111111111
1000000001
1011000001
1000010001
1000000001
10000N0101
1010000001
1000000001
1000010001
1111111111